Basic 61=Basic 61
As well as=in addition to, not only 뿐만 아니라
classic=typical 전형적인,전통적인
cling to=hold tightly, stick to 들러붙다,집착하다
disassemble=break apart, break up, disrupt, divide, separate, split, dismantle 해체하다,분해하다
erode=diminish 침식 하다, 서서히 파괴하다
focal area=central area 초점지역,중심지역
intact=unchanged, unbroken, whole, in one piece 손상되지 않은,온전한
lure=attract, seduce, entice, draw, allure 유혹하다
migrate=move, shift 이주하다,이동하다
predominantly=dominantly, primarily 주요하게 
reserve=(1) set aside, allocate, allot, appoint, apportion, assign 따로 떼어놓다, 할당하다
reserve=(2) keep, conserve, have, hold, maintain, possess, preserve, retain, save, store 갖다, 보유하다
rival=(1) compete from , contest, contend, match ~와 경쟁하다
rival=(2) opponent, competitor, enemy, foe, match 맞수, 적, 상대방
rugged=uneven, irregular 울퉁불퉁한, 고르지 않은, 편평하지 않은 
semiarid=rather dry, scanty rainfall  다소 건조한, 강수량이 적은
Arid=dry, barren, desert, parched 건조한 
separate=distinct 각각의, 개별적인 
sequent=later, following subsequent 다음의
specifically=especially 특별하게
spring up=suddenly arise, appear, develop, grow, happen, emerge, occur 갑자기 나타나다, 갑자기 생겨나다 
substantial=considerable 상당한,중요한
subtle=slight 미묘한 
thrive=flourish, prosper번성번영하다
treat=handle, deal with  다루다, 처리하다 
uniformly=evenly한결같이,일률적으로
unsurpassed=superior, excellent, paramount, perfect, unparalleled, supreme, foremost 탁월한
vanish=disappear사라지다,없어지다
vital=essential아주중요한
Stimulate=spur, instigate ~을자극하다
acquisition=purchase 획득,습득,취득물
property=quality, aspect, feature, characteristic, attribute, trait  특성
crown=(1) royalty, ruler, monarch 왕위, 왕권
crown=(2) raise  왕관을 씌우다, 왕위에 앉히다, 왕좌에 올리다
crown=(3) cover 덮다, 씌우다
document=record 기록하다 
leisurely=relaxed 느긋한
unquestionable=reliable, trustworthy, dependable 믿을 수 있는
Basic 62=Basic 62
accommodate=adjust , adapt 적응하다
amplify=increase 확대하다,증대하다,증강하다
best suited=most appropriate  가장 알맞은
calculate=determine, judge   ①계산하다,산출하다 ②결정하다,평가하다
chronic=persistent, habitual, regular, continual, constant, enduring, fixed, inveterate, lasting  만성인, 일상적인 
counterparts=equivalents 비교되는 다른 한 쪽, 상대방 
derive=originate 이끌어내다,유래하다
disposition=characteristic, tendency, nature 기질,성질 
dissimilar=different 닮지 않은,다른
distribute=scatter, disseminate, disperse, spread 살포하다,뿌리다
drive=force, push, compel, thrust, propel  강요하다, ~하게 하다 
in spite of=regardless of, despite, notwithstanding, even if, even though, though, albeit   에도불구하고
indigenous=native, original 토착의,고유한
outrageous=(1) shocking, terrible, atrocious, offensive, cruel, savage,  난폭한,지나친,엉뚱한,엄청난
outrageous=(2) unreasonable, unfair, preposterous 말도 안되는, 터무니없는
perceptibly=noticeably 꽤 많이,상당히
pliable=compliant, docile, ductile, flexible, manageable, obedient, malleable, receptive, responsive, submissive, supple, yielding 유연한,유순한, 말 잘 듣는 
plumage=feather깃털
realm=area,region영역,범위,분야
relevant=applicable, pertinent 적절한 
reluctant=unwilling 꺼려하는, 주저하는, 하기 싫은 
reserved=restricted (따로 떼어놓았기 때문에, 아무나 사용할 수 없는, 그러므로) “제한된” (ex) a reserved seat 아무나 이용할 수 없는, 사용이 “제한되는” 예약석, 지정석. a reserved car 아무나 이용할 수 없는 사용이 특정인에게만 “제한되는” 전세차
sequence=series, order연속,순서
yield=produce 산출하다,포기하다,양보하다
notable=remarkable 주목할만한,뛰어난
pare away=remove 벗기다,제거하다
echo=repeat,reply,resound,reverberate 반향하다, 울리다
substitute=replacement 교체,대체
consequence=(1) result, outcome, product 결과
consequence=(2) effect, influence,impact 영향력
modify=revise, change 변형하다
detach=separate 분리하다
